111111111111
1P1111111111
101111111111
100C000000E1
111111111111